111111111
110C1111
100E111
1PPP11
11111