111111111
1P000C001
100111001
100M00001
100111001
1000C0001
100111001
10000E001
111111111
