111111111
1P000C001
1000C0001
1000ME001
111111111
